21
#####################################################################################
###############################.........#############################################
##########.############################.#############################################
######...#...#############.........###...############################################
##.............######.......................#########################################
##..............####..................................###############################
##..........#...#...#...............................#################################
#...........#..##......................................##############################
##..........#..##................................################..........##########
............#..##........................################....................########
#...........#..##...###......................##########.........#...........#########
##..........#..##...####.....................##########....########.......###########
##.###......#.......#########.............#############..############################
##..###.....#...#...###############...........................#######################
#...##..........#...##################...................############################
#....###........##..##################....###########################################
#....#####.....#....##################....########################....###############
################.....#################.................................##############
#################....#############################################....###############
###################.#################################################################
#####################################################################################

0 9 0